1111111111111111111111111111111111
10100PEC0000000C00000C000000000001
1010010100100000101001000001010101
1010010010101010001001000000010101
1X0000000C00C00000000X0000000000C1
1111111111111111111111111111111111
